####################
#  y               #
#                  #
#                  #
#    ###      y    #
#    ###           #
#            ###   #
#            ###   #
#                  #
#       ###        #
#       ###        #
#                  #
#               ####
# x           #    #
#                  #
####################
