####################
##                ##
#    y             #
#                  #
#    ###      y    #
#    ###           #
#           ###    #
#           ###    #
#                  #
#       ###        #
#       ###        #
#                  #
#               ####
# x                #
##                ##
####################
