####################
##  y             ##
#                  #
#                  #
#    ###      y    #
#    ###           #
#            ###   #
#            ###   #
#                  #
#       ###        #
#       ###        #
#                  #
#               ####
# x                #
##                ##
####################
