####################
#                  #
#                  #
#                  #
#    ###      y    #
#    ###           #
#           ###    #
#           ###    #
#                  #
#       ###        #
#       ###        #
#                  #
#               ####
# x                #
#                  #
####################
