####################
#                  #
#                  #
#        x         #
#                  #
#                  #
#                  #
#                  #
#        ##        #
#                  #
#                  #
#                  #
#                  #
#         y        #
#                  #
####################
