####################
#                  #
#                  #
#                  #
#                  #
#                  #
#                  #
#                  #
#        #         #
#                  #
#                  #
#                  #
#                  #
#                  #
#                  #
####################
