####################
#                  #
#         x        #
#                  #
#                  #
#                  #
#                  #
#                  #
#                  #
#    y   #   y     #
#                  #
#        y         #
#                  #
#                  #
#                  #
####################
