####################
#                  #
#   ###      ###   #
#    X        X    #
#                  #
#   ###      ###   #
#                  #
#                  #
#        #         #
#                  #
#                  #
#    #########     #
#                  #
#      @           #
#                  #
####################
