####################
#                  #
#                  #
#    x             #
#                  #
#   ###      ###   #
#                  #
#                  #
#                  #
#                  #
#     #######      #
#    #########     #
#                  #
#      y        y  #
#                  #
####################
