####################
#                  #
#   ###      ###   #
#    x             #
#                  #
#   ###      ###   #
#                  #
#                  #
#        #         #
#                  #
#                  #
#    #########     #
#                  #
#      y           #
#                  #
####################
