####################
##                ##
#                  #
#    x             #
#                  #
#   ###      ###   #
#                  #
#                  #
#                  #
#                  #
#     #######      #
#    #########     #
#                  #
#               y  #
##                ##
####################
