####################
##                ##
#                  #
#             y    #
#                  #
#   ###      ###   #
#                  #
#                  #
#                  #
#                  #
#     #######      #
#    #########     #
#                  #
#      x           #
##                ##
####################
