####################
##                ##
#                  #
#                  #
#    #       #     #
#    #       #     #
#   x#       # y   #
#    #       #     #
#    #       #     #
#    #       #     #
#    #       #     #
#                  #
#                  #
#                  #
##                ##
####################
