####################
#                  #
#    #       #     #
#    #       #     #
#    #       #     #
#    #       #     #
#    #       #     #
#    #       #     #
#    #       #     #
#    #       #     #
#    #       #     #
#                  #
#                  #
#                  #
#                  #
####################
