####################
#                  #
#                  #
#    ###           #
#                  #
#      ###         #
#                  #
#   #    ###       #
#   #              #
#   #      ###     #
#   #              #
#   #        ###   #
#   #              #
#                  #
#                  #
####################
