####################
#                  #
#    x             #
#       ###        #
#                  #
#         y        #
#                  #
#   #      ###     #
#   #              #
#   #              #
#   #              #
#  y#        ###   #
#   #          y   #
#                  #
#                  #
####################
