####################
#                  #
#    x             #
#    ###           #
#                  #
#      ###         #
#                  #
#   #    ###       #
#   #              #
#   #      ###     #
#   #              #
#   #        ###   #
#   #          y   #
#                  #
#                  #
####################
