####################
#                  #
#                  #
#        ###       #
#       #   #      #
#      #     #     #
#     #       #    #
#    #         #   #
#                  #
#                  #
#        ###       #
#                  #
#                  #
#                  #
#                  #
####################
