####################
#                  #
#          y       #
#        ###       #
#      x#   # y    #
#      #     #     #
#     #       #    #
#    #         #   #
#                  #
#                  #
#        ###       #
#                  #
#        y         #
#                  #
#                  #
####################
