####################
#                  #
#    #        y    #
#          #       #
#              #   #
#     #            #
#                  #
#   x        #     #
#         #        #
#   #         y    #
#               #  #
#       #  #       #
#         y        #
#                  #
#                  #
####################
