####################
##                ##
#    #             #
#          #       #
#              #   #
#  y  #            #
#         y        #
#            #     #
#      x  #        #
#   #         y    #
#               #  #
#       #  #       #
#         y        #
#                  #
##                ##
####################
