####################
#                  #
#    #             #
#          #       #
#              #   #
#     #            #
#                  #
#            #     #
#         #        #
#   #              #
#               #  #
#       #  #       #
#                  #
#                  #
#                  #
####################
