####################
##                ##
#    #             #
#          #       #
#              #   #
#     #            #
#         y        #
#            #     #
#      x  #        #
#   #              #
#               #  #
#       #  #       #
#                  #
#                  #
##                ##
####################
