####################
#    #             #
#    #             #
#    #####         #
#                  #
#              #   #
#              #   #
#              #   #
#  #      #    #   #
#  #           #####
#  #               #
####               #
#                  #
#                  #
#                  #
####################
