####################
##    #           ##
#    #  y          #
#    #####         #
#                  #
#              #   #
#  y           #   #
#              #   #
#  #           # y #
#  #           #####
# x#               #
####               #
#                  #
#              y   #
##                ##
####################
