####################
##    #           ##
#    #  y          #
#    #####         #
#                  #
#              #   #
#              #   #
#              #   #
#  #      #    #   #
#  #           #####
# x#               #
####               #
#                  #
#                  #
##                ##
####################
