####################
#                  #
#                  #
#    #   y   #     #
#   #         #    #
# #            #   #
#                # #
#       #          #
#      #  #        #
#     #    #       #
#                  #
#                  #
#      ####        #
#        x         #
#                  #
####################
