####################
#                  #
#                  #
#    #       #     #
#   #         #    #
# #            #   #
#                # #
#       #          #
#      #  #        #
#     #    #       #
#                  #
#                  #
#      ####        #
#                  #
#                  #
####################
