####################
##                ##
#                  #
#    #       #     #
#   #         #    #
# #            #   #
#       y       #  #
#       #          #
#    y #  #  y     #
#     #    #       #
#        y         #
#                  #
#      ####        #
#        x         #
##                ##
####################
