####################
#                  #
#                  #
#    #       #     #
#   #         #    #
# #            #   #
#       y       #  #
#       #          #
#    y #  #  y     #
#     #    #       #
#                  #
#                  #
#      ####        #
#        x         #
#                  #
####################
