####################
##                ##
#                  #
#    y   #         #
#        #         #
#        #         #
#       x#y        #
#    ########      #
#       y#y        #
#        #         #
#        #         #
#        #         #
#                  #
#                  #
##                ##
####################
