####################
##                ##
#                  #
#    x   #         #
#        #         #
#        #         #
#        #y        #
#    ########      #
#       y#y        #
#        #         #
#        #         #
#        #         #
#                  #
#                  #
##                ##
####################
