####################
#                  #
#                  #
#    x   #         #
#        #         #
#        #         #
#        #y        #
#    ########      #
#       y#y        #
#        #         #
#        #         #
#        #         #
#                  #
#                  #
#                  #
####################
