####################
#                  #
#                  #
#        #         #
#        #         #
#        #         #
#       x#         #
#    ########      #
#        #y        #
#        #         #
#        #         #
#        #         #
#                  #
#                  #
#                  #
####################
